00444444444400444444444400
00444444444400444444444400
00000011111100111111004444
00000011111100111111000000
00000000000000000001110000
44440000000000000001114444
44440011111100111111114444
11110011111100111550001111
11110000001100111550001111
44440000001100550011004444
44440022222100551111004444
44440011122100111111005555
00005500442244224455004444
11115500442244224455004444
55110000000011000022222255
55000000004411440022000055
22000000004455440022000022
44110011002255220011001122
44115500011111111444444422
44115500011111111444444422
44110011001111110011001122
55110011000000000011001122
55110011000000000011001122
22110011000111100011001122
22000000000130100000444400
00000000000100100000444400